[
  {
    "width": 8,
    "monsters": 5,
    "healingPotions": 2,
    "fireBlasts": 1,
    "pushWalls": 1,
    "tiles": [
      1, 3, 1, 1, 3, 1, 1, 1,
      1, 0, 0, 2, 0, 0, 0, 1,
      1, 4, 0, 3, 4, 0, 0, 3,
      2, 0, 0, 0, 0, 0, 4, 3,
      1, 4, 0, 1, 3, 1, 0, 1,
      1, 0, 1, 2, 0, 0, 0, 1,
      10, 9, 10, 1, 0, 4, 4, 1,
      1, 11, 3, 1, 1, 3, 1, 1
    ],
    "things": [
      0, 0, 0, 0, 0, 0, 0, 0,
      0, 0, 0, 0, 0, 0, 0, 0,
      0, 0, 0, 0, 0, 0, 0, 0,
      0, 0, 0, 0, 0, 0, 0, 0,
      0, 0, 0, 0, 0, 0, 0, 0,
      0, 0, 0, 0, 0, 0, 0, 0,
      0, 0, 0, 0, 1, 0, 0, 0,
      0, 0, 0, 0, 0, 0, 0, 0
    ]
  }
]

