[
  {
    "width": 8,
    "tiles": [
      1, 3, 1, 1, 3, 1, 1, 1,
      1, 0, 0, 2, 0, 0, 0, 1,
      1, 4, 0, 3, 4, 0, 0, 3,
      2, 0, 0, 0, 0, 0, 4, 3,
      1, 4, 0, 1, 3, 1, 0, 1,
      1, 0, 1, 2, 0, 0, 0, 1,
      10, 9, 10, 1, 0, 4, 4, 1,
      1, 11, 3, 1, 1, 3, 1, 1
    ],
    "things": [
      0, 0, 0, 0, 0, 0, 0, 0,
      0, 2, 0, 0, 2, 0, 0, 0,
      0, 0, 0, 0, 0, 0, 0, 0,
      0, 6, 0, 3, 0, 0, 0, 0,
      0, 0, 0, 0, 4, 0, 3, 0,
      0, 3, 0, 0, 0, 0, 0, 0,
      0, 0, 0, 0, 1, 0, 6, 0,
      0, 5, 0, 0, 0, 0, 0, 0
    ]
  },
  {
    "width": 5,
    "tiles": [
      2, 1, 1, 10, 1,
      1, 0, 4, 9, 11,
      1, 1, 1, 10, 1,
      2, 0, 0, 1, 3,
      1, 0, 3, 1, 3,
      1, 1, 1, 1, 1
    ],
    "things": [
      0, 0, 0, 0, 0,
      0, 1, 3, 0, 5,
      0, 4, 0, 0, 0,
      0, 0, 2, 0, 0,
      0, 0, 0, 0, 0,
      0, 0, 0, 0, 0
    ]
  },
  {
    "width": 16,
    "tiles": [
      1, 1, 1, 1, 1, 1, 1, 1, 1, 1, 1, 1, 1, 1, 1, 1,
      1, 0, 1, 0, 0, 1, 0, 0, 0, 0, 1, 0, 0, 1, 0, 1,
      1, 0, 1, 0, 0, 1, 0, 1, 1, 0, 1, 0, 0, 1, 0, 1,
      1, 0, 0, 0, 0, 0, 0, 0, 1, 0, 0, 0, 0, 0, 0, 1,
      1, 1, 1, 1, 1, 0, 0, 0, 1, 1, 1, 1, 0, 1, 1, 1,
      1, 0, 0, 0, 1, 0, 0, 0, 1, 0, 0, 0, 0, 1, 1, 1,
      1, 0, 1, 0, 1, 1, 1, 1, 1, 0, 0, 0, 0, 1, 0, 1,
      1, 0, 0, 0, 0, 0, 1, 1, 1, 0, 1, 1, 1, 1, 0, 1,
      1, 0, 0, 1, 0, 1, 0, 0, 0, 0, 0, 0, 1, 1, 0, 1,
      1, 0, 0, 1, 0, 1, 0, 0, 0, 0, 0, 0, 1, 0, 0, 1,
      1, 0, 0, 0, 0, 0, 0, 0, 0, 0, 0, 0, 1, 0, 0, 1,
      1, 0, 1, 0, 1, 1, 1, 1, 1, 1, 0, 1, 1, 0, 0, 1,
      1, 0, 0, 0, 0, 0, 0, 0, 0, 0, 0, 0, 0, 0, 0, 1,
      1, 0, 0, 0, 1, 1, 0, 0, 0, 1, 0, 1, 0, 0, 0, 1,
      1, 0, 1, 0, 0, 0, 0, 0, 1, 0, 0, 0, 0, 1, 0, 1,
      1, 0, 0, 0, 0, 0, 0, 0, 0, 0, 0, 0, 0, 0, 0, 1,
      1, 1, 1, 1, 1, 1, 1, 1, 1, 1, 1, 1, 1, 1, 1, 1
    ],
    "things": [
      0, 0, 0, 0, 0, 0, 0, 0, 0, 0, 0, 0, 0, 0, 0, 0,
      0, 1, 0, 0, 2, 0, 0, 0, 0, 0, 0, 0, 0, 0, 2, 0,
      0, 0, 0, 0, 0, 0, 3, 0, 0, 0, 0, 0, 0, 0, 3, 0,
      0, 0, 3, 0, 0, 0, 0, 0, 0, 0, 2, 0, 0, 0, 0, 0,
      0, 0, 0, 0, 0, 0, 0, 0, 0, 0, 0, 0, 0, 0, 0, 0,
      0, 0, 0, 0, 0, 2, 0, 0, 0, 0, 0, 0, 0, 0, 5, 0,
      0, 0, 2, 0, 0, 0, 0, 0, 0, 0, 0, 0, 0, 0, 3, 0,
      0, 0, 0, 0, 0, 0, 0, 0, 0, 0, 0, 0, 0, 0, 2, 0,
      0, 0, 0, 0, 0, 0, 0, 0, 0, 0, 0, 0, 0, 0, 0, 0,
      0, 0, 0, 0, 0, 0, 0, 0, 0, 0, 0, 0, 0, 2, 0, 0,
      0, 0, 0, 0, 0, 3, 2, 0, 0, 0, 2, 0, 0, 0, 0, 0,
      0, 0, 0, 0, 0, 0, 0, 0, 0, 0, 3, 0, 0, 0, 0, 0,
      0, 2, 0, 0, 0, 0, 0, 0, 2, 3, 0, 3, 0, 0, 0, 0,
      0, 0, 0, 0, 0, 0, 0, 0, 0, 0, 3, 0, 0, 0, 0, 0,
      0, 0, 0, 0, 0, 2, 0, 0, 0, 0, 0, 0, 0, 0, 0, 0,
      0, 0, 0, 0, 0, 0, 0, 0, 0, 0, 2, 0, 0, 2, 0, 0,
      0, 0, 0, 0, 0, 0, 0, 0, 0, 0, 0, 0, 0, 0, 0, 0
    ]
  }
]

