[
  {
    "width": 8,
    "monsters": 2,
    "monsterBlobs": 1,
    "healingPotions": 2,
    "fireBlasts": 1,
    "pushWalls": 1,
    "seed": 2,
    "tiles": [
      1, 3, 1, 1, 3, 1, 1, 1,
      1, 0, 0, 2, 0, 0, 0, 1,
      1, 4, 0, 3, 4, 0, 0, 3,
      2, 0, 0, 0, 0, 0, 4, 3,
      1, 4, 0, 1, 3, 1, 0, 1,
      1, 0, 1, 2, 0, 0, 0, 1,
      10, 9, 10, 1, 0, 4, 4, 1,
      1, 11, 3, 1, 1, 3, 1, 1
    ]
  },
  {
    "width": 16,
    "monsters": 10,
    "monsterBlobs": 3,
    "healingPotions": 2,
    "fireBlasts": 1,
    "pushWalls": 1,
    "tiles": [
      1, 1, 1, 1, 1, 1, 1, 1, 1, 1, 1, 1, 1, 1, 1, 1,
      1, 0, 1, 0, 0, 1, 0, 0, 0, 0, 1, 0, 0, 1, 0, 1,
      1, 0, 1, 0, 0, 1, 0, 1, 1, 0, 1, 0, 0, 1, 0, 1,
      1, 0, 0, 0, 0, 0, 0, 0, 1, 0, 0, 0, 0, 0, 0, 1,
      1, 1, 1, 1, 1, 0, 0, 0, 1, 1, 1, 1, 0, 1, 1, 1,
      1, 0, 0, 0, 1, 0, 0, 0, 1, 0, 0, 0, 0, 1, 11, 1,
      1, 0, 1, 0, 1, 1, 1, 1, 1, 0, 0, 0, 0, 1, 9, 1,
      1, 0, 0, 0, 0, 0, 1, 1, 1, 0, 1, 1, 1, 1, 0, 1,
      1, 0, 0, 1, 0, 1, 0, 0, 0, 0, 0, 0, 1, 1, 0, 1,
      1, 0, 0, 1, 0, 1, 0, 0, 0, 0, 0, 0, 1, 0, 0, 1,
      1, 0, 0, 0, 0, 0, 0, 0, 0, 0, 0, 0, 1, 0, 0, 1,
      1, 0, 1, 0, 1, 1, 1, 1, 1, 1, 0, 1, 1, 0, 0, 1,
      1, 0, 0, 0, 0, 0, 0, 0, 0, 0, 0, 0, 0, 0, 0, 1,
      1, 0, 0, 0, 1, 1, 0, 0, 0, 1, 0, 1, 0, 0, 0, 1,
      1, 0, 1, 0, 0, 0, 0, 0, 1, 0, 0, 0, 0, 1, 0, 1,
      1, 0, 0, 0, 0, 0, 0, 0, 0, 0, 0, 0, 0, 0, 0, 1,
      1, 1, 1, 1, 1, 1, 1, 1, 1, 1, 1, 1, 1, 1, 1, 1
    ]
  },
  {
    "width": 8,
    "monsters": 0,
    "monsterBlobs": 0,
    "healingPotions": 2,
    "fireBlasts": 1,
    "pushWalls": 0,
    "seed": 1,
    "tiles": [
      1, 1, 1, 1, 1, 1, 1, 1,
      1, 9, 1, 0, 0, 0, 0, 1,
      1, 0, 0, 0, 0, 0, 0, 1,
      1, 0, 0, 0, 0, 0, 0, 1,
      1, 0, 0, 2, 0, 0, 0, 1,
      1, 0, 0, 0, 0, 0, 0, 1,
      1, 0, 0, 0, 0, 0, 0, 1,
      1, 1, 1, 1, 1, 1, 1, 1
    ]
  }
]

